......*........
.p....o........
.pp............
.*;...fp*......
.....*fpo......
...MMMMM...f...
...........fM..
...*ooooo..fp*.
..*oooo........
...............
